cn_a	y a
cn_ai	y ai
cn_ao	y ao
cn_an	y an
cn_ang	y ang
cn_e	y e
cn_er	y er
cn_ei	y ei
cn_en	y en
cn_eng	y eng
cn_o	y o
cn_ou	y ou
cn_ong	y ong
cn_i	y i
cn_ia	y ia
cn_iao	y iao
cn_ian	y ian
cn_iang	y iang
cn_ie	y ie
cn_io	y io
cn_iou	y iou
cn_iong	y iong
cn_in	y in
cn_ing	y ing
cn_u	y u
cn_ua	y ua
cn_uai	y uai
cn_uan	y uan
cn_uang	y uang
cn_uei	y uei
cn_uo	y uo
cn_uen	y uen
cn_ueng	y ueng
cn_v	y v
cn_ve	y ve
cn_van	y van
cn_vn	y vn
cn_ba	b a
cn_bai	b ai
cn_bao	b ao
cn_ban	b an
cn_bang	b ang
cn_be	b e
cn_bei	b ei
cn_ben	b en
cn_beng	b eng
cn_bo	b o
cn_bou	b ou
cn_bi	b i
cn_bia	b ia
cn_biao	b iao
cn_bian	b ian
cn_biang	b iang
cn_bie	b ie
cn_bio	b io
cn_biou	b iou
cn_biong	b iong
cn_bin	b in
cn_bing	b ing
cn_bu	b u
cn_pa	p a
cn_pai	p ai
cn_pao	p ao
cn_pan	p an
cn_pang	p ang
cn_pe	p e
cn_pei	p ei
cn_pen	p en
cn_peng	p eng
cn_po	p o
cn_pou	p ou
cn_pi	p i
cn_pia	p ia
cn_piao	p iao
cn_pian	p ian
cn_piang	p iang
cn_pie	p ie
cn_pio	p io
cn_piou	p iou
cn_piong	p iong
cn_pin	p in
cn_ping	p ing
cn_pu	p u
cn_m	m u
cn_ma	m a
cn_mai	m ai
cn_mao	m ao
cn_man	m an
cn_mang	m ang
cn_me	m e
cn_mei	m ei
cn_men	m en
cn_meng	m eng
cn_mo	m o
cn_mou	m ou
cn_mi	m i
cn_mia	m ia
cn_miao	m iao
cn_mian	m ian
cn_miang	m iang
cn_mie	m ie
cn_mio	m io
cn_miou	m iou
cn_miong	m iong
cn_min	m in
cn_ming	m ing
cn_mu	m u
cn_fa	f a
cn_fai	f ai
cn_fao	f ao
cn_fan	f an
cn_fang	f ang
cn_fe	f e
cn_fei	f ei
cn_fen	f en
cn_feng	f eng
cn_fo	f o
cn_fou	f ou
cn_fu	f u
cn_da	d a
cn_dai	d ai
cn_dao	d ao
cn_dan	d an
cn_dang	d ang
cn_de	d e
cn_dei	d ei
cn_den	d en
cn_deng	d eng
cn_dou	d ou
cn_dong	d ong
cn_di	d i
cn_dia	d ia
cn_diao	d iao
cn_dian	d ian
cn_diang	d iang
cn_die	d ie
cn_dio	d io
cn_diou	d iou
cn_diong	d iong
cn_din	d in
cn_ding	d ing
cn_du	d u
cn_duan	d uan
cn_duei	d uei
cn_duo	d uo
cn_duen	d uen
cn_ta	t a
cn_tai	t ai
cn_tao	t ao
cn_tan	t an
cn_tang	t ang
cn_te	t e
cn_tei	t ei
cn_ten	t en
cn_teng	t eng
cn_tou	t ou
cn_tong	t ong
cn_ti	t i
cn_tia	t ia
cn_tiao	t iao
cn_tian	t ian
cn_tiang	t iang
cn_tie	t ie
cn_tio	t io
cn_tiou	t iou
cn_tiong	t iong
cn_tin	t in
cn_ting	t ing
cn_tu	t u
cn_tuan	t uan
cn_tuei	t uei
cn_tuo	t uo
cn_tuen	t uen
cn_na	n a
cn_nai	n ai
cn_nao	n ao
cn_nan	n an
cn_nang	n ang
cn_ne	n e
cn_nei	n ei
cn_nen	n en
cn_neng	n eng
cn_nou	n ou
cn_nong	n ong
cn_ni	n i
cn_nia	n ia
cn_niao	n iao
cn_nian	n ian
cn_niang	n iang
cn_nie	n ie
cn_nio	n io
cn_niou	n iou
cn_niong	n iong
cn_nin	n in
cn_ning	n ing
cn_nu	n u
cn_nuan	n uan
cn_nuei	n uei
cn_nuo	n uo
cn_nuen	n uen
cn_nv	n v
cn_nve	n ve
cn_la	l a
cn_lai	l ai
cn_lao	l ao
cn_lan	l an
cn_lang	l ang
cn_le	l e
cn_lei	l ei
cn_len	l en
cn_leng	l eng
cn_lo	l o
cn_lou	l ou
cn_long	l ong
cn_li	l i
cn_lia	l ia
cn_liao	l iao
cn_lian	l ian
cn_liang	l iang
cn_lie	l ie
cn_lio	l io
cn_liou	l iou
cn_liong	l iong
cn_lin	l in
cn_ling	l ing
cn_lu	l u
cn_luan	l uan
cn_luei	l uei
cn_luo	l uo
cn_luen	l uen
cn_lv	l v
cn_lve	l ve
cn_ga	g a
cn_gai	g ai
cn_gao	g ao
cn_gan	g an
cn_gang	g ang
cn_ge	g e
cn_gei	g ei
cn_gen	g en
cn_geng	g eng
cn_gou	g ou
cn_gong	g ong
cn_gu	g u
cn_gua	g ua
cn_guai	g uai
cn_guan	g uan
cn_guang	g uang
cn_guei	g uei
cn_guo	g uo
cn_guen	g uen
cn_ka	k a
cn_kai	k ai
cn_kao	k ao
cn_kan	k an
cn_kang	k ang
cn_ke	k e
cn_kei	k ei
cn_ken	k en
cn_keng	k eng
cn_kou	k ou
cn_kong	k ong
cn_ku	k u
cn_kua	k ua
cn_kuai	k uai
cn_kuan	k uan
cn_kuang	k uang
cn_kuei	k uei
cn_kuo	k uo
cn_kuen	k uen
cn_ha	h a
cn_hai	h ai
cn_hao	h ao
cn_han	h an
cn_hang	h ang
cn_he	h e
cn_hei	h ei
cn_hen	h en
cn_heng	h eng
cn_hou	h ou
cn_hong	h ong
cn_hu	h u
cn_hua	h ua
cn_huai	h uai
cn_huan	h uan
cn_huang	h uang
cn_huei	h uei
cn_huo	h uo
cn_huen	h uen
cn_zha	zh a
cn_zhai	zh ai
cn_zhao	zh ao
cn_zhan	zh an
cn_zhang	zh ang
cn_zhe	zh e
cn_zhei	zh ei
cn_zhen	zh en
cn_zheng	zh eng
cn_zhou	zh ou
cn_zhong	zh ong
cn_zhiii	zh iii
cn_zhu	zh u
cn_zhua	zh ua
cn_zhuai	zh uai
cn_zhuan	zh uan
cn_zhuang	zh uang
cn_zhuei	zh uei
cn_zhuo	zh uo
cn_zhuen	zh uen
cn_cha	ch a
cn_chai	ch ai
cn_chao	ch ao
cn_chan	ch an
cn_chang	ch ang
cn_che	ch e
cn_chei	ch ei
cn_chen	ch en
cn_cheng	ch eng
cn_chou	ch ou
cn_chong	ch ong
cn_chiii	ch iii
cn_chu	ch u
cn_chua	ch ua
cn_chuai	ch uai
cn_chuan	ch uan
cn_chuang	ch uang
cn_chuei	ch uei
cn_chuo	ch uo
cn_chuen	ch uen
cn_sha	sh a
cn_shai	sh ai
cn_shao	sh ao
cn_shan	sh an
cn_shang	sh ang
cn_she	sh e
cn_shei	sh ei
cn_shen	sh en
cn_sheng	sh eng
cn_shou	sh ou
cn_shiii	sh iii
cn_shu	sh u
cn_shua	sh ua
cn_shuai	sh uai
cn_shuan	sh uan
cn_shuang	sh uang
cn_shuei	sh uei
cn_shuo	sh uo
cn_shuen	sh uen
cn_ra	r a
cn_rai	r ai
cn_rao	r ao
cn_ran	r an
cn_rang	r ang
cn_re	r e
cn_rei	r ei
cn_ren	r en
cn_reng	r eng
cn_rou	r ou
cn_rong	r ong
cn_riii	r iii
cn_ru	r u
cn_ruan	r uan
cn_ruei	r uei
cn_ruo	r uo
cn_ruen	r uen
cn_za	z a
cn_zai	z ai
cn_zao	z ao
cn_zan	z an
cn_zang	z ang
cn_ze	z e
cn_zei	z ei
cn_zen	z en
cn_zeng	z eng
cn_zou	z ou
cn_zong	z ong
cn_zii	z ii
cn_zu	z u
cn_zuan	z uan
cn_zuei	z uei
cn_zuo	z uo
cn_zuen	z uen
cn_ca	c a
cn_cai	c ai
cn_cao	c ao
cn_can	c an
cn_cang	c ang
cn_ce	c e
cn_cei	c ei
cn_cen	c en
cn_ceng	c eng
cn_cou	c ou
cn_cong	c ong
cn_cii	c ii
cn_cu	c u
cn_cuan	c uan
cn_cuei	c uei
cn_cuo	c uo
cn_cuen	c uen
cn_sa	s a
cn_sai	s ai
cn_sao	s ao
cn_san	s an
cn_sang	s ang
cn_se	s e
cn_sei	s ei
cn_sen	s en
cn_seng	s eng
cn_sou	s ou
cn_song	s ong
cn_sii	s ii
cn_su	s u
cn_suan	s uan
cn_suei	s uei
cn_suo	s uo
cn_suen	s uen
cn_ji	j i
cn_jia	j ia
cn_jiao	j iao
cn_jian	j ian
cn_jiang	j iang
cn_jie	j ie
cn_jio	j io
cn_jiou	j iou
cn_jiong	j iong
cn_jin	j in
cn_jing	j ing
cn_jv	j v
cn_jve	j ve
cn_jvan	j van
cn_jvn	j vn
cn_qi	q i
cn_qia	q ia
cn_qiao	q iao
cn_qian	q ian
cn_qiang	q iang
cn_qie	q ie
cn_qio	q io
cn_qiou	q iou
cn_qiong	q iong
cn_qin	q in
cn_qing	q ing
cn_qv	q v
cn_qve	q ve
cn_qvan	q van
cn_qvn	q vn
cn_xi	x i
cn_xia	x ia
cn_xiao	x iao
cn_xian	x ian
cn_xiang	x iang
cn_xie	x ie
cn_xio	x io
cn_xiou	x iou
cn_xiong	x iong
cn_xin	x in
cn_xing	x ing
cn_xv	x v
cn_xve	x ve
cn_xvan	x van
cn_xvn	x vn
cn_xer	x er
cn_rua	r ua
cn_fiao	f iao
cn_kiou	k iou
en_sheep	SH IY1 P
en_building	B IH1 L D IH0 NG
en_a	AH0
en_i	AY1
en_six	S IH1 K S
